1111111111
1000010B01
10A0010001
1000000001
1111111111